######
#X121#
#112O#
#1#11#
#1111#
#1111#
######