######
#X111#
#111O#
#1111#
#1111#
#1111#
######